64
64
1111111111222222222222222222222222222222222222222222221111111111
1000000001111111111111111111112222111111111111111111111000000001
1000000001000000000000000000011111100000000000000000001000000001
1000000000000000000000000000000000000000000000000000000000000001
1000000000000000000000000000000000000000000000000000000000000001
1000000000000000000000000000000000000000000000000000000000000001
1000000000000000000000000000000000000000000000000000000000000001
1000000001000000000000000000010000100000000000000000001000000001
1000000001111111111111111111110000111111111111111111111000000001
1110000111000000000000000000000000000000000000000000001110000111
2100000010000000000000000000000000000000000000000000000100000012
2100000010000000000000000000000000000000000000000000000100000012
2100000010000000000000000000000000000000000000000000000100000012
2100000010000000000000000000000000000000000000000000000100000012
2100000010000000000000000000000000000000000000000000000100000012
2100000010000000000000000000000000000000000000000000000100000012
2100000010000000000000000000000000000000000000000000000100000012
2100000010000000000000000000111111110000000000000000000100000012
2100000010000000000000000000000000000000000000000000000100000012
2100000010000000000000000000000000000000000000000000000100000012
2100000010000000000000000000000000000000000000000000000100000012
2100000010000000000000000000000000000000000000000000000100000012
2100000010000000000000000000000000000000000000000000000100000012
2100000010000000000000000000000000000000000000000000000100000012
2100000010000000000000000000000000000000000000000000000100000012
2100000010000000000000000000000000000000000000000000000100000012
2100000010000000000000000000000000000000000000000000000100000012
2100000010000000000000000000000000000000000000000000000100000012
2100000010000000001000000000000000000000000000100000000100000012
2110000110000000001000000000000000000000000000100000000110000112
2210000000000000001000000000000000000000000000100000000000000122
2210000000000000001000000000000000000000000000100000000000000122
2210000000000000001000000000000000000000000000100000000000000122
2210000000000000001000000000000000000000000000100000000000000122
2110000110000000001000000000000000000000000000100000000110000112
2100000010000000001000000000000000000000000000100000000100000012
2100000010000000000000000000000000000000000000000000000100000012
2100000010000000000000000000000000000000000000000000000100000012
2100000010000000000000000000000000000000000000000000000100000012
2100000010000000000000000000000000000000000000000000000100000012
2100000010000000000000000000000000000000000000000000000100000012
2100000010000000000000000000000000000000000000000000000100000012
2100000010000000000000000000000000000000000000000000000100000012
2100000010000000000000000000000000000000000000000000000100000012
2100000010000000000000000000000000000000000000000000000100000012
2100000010000000000000000000000000000000000000000000000100000012
2100000010000000000000000000111111110000000000000000000100000012
2100000010000000000000000000000000000000000000000000000100000012
2100000010000000000000000000000000000000000000000000000100000012
2100000010000000000000000000000000000000000000000000000100000012
2100000010000000000000000000000000000000000000000000000100000012
2100000010000000000000000000000000000000000000000000000100000012
2100000010000000000000000000000000000000000000000000000100000012
2100000010000000000000000000000000000000000000000000000100000012
1110000111000000000000000000000000000000000000000000001110000111
1000000001111111111111111111110000111111111111111111111000000001
1000000001000000000000000000010000100000000000000000001000000001
1000000000000000000000000000000000000000000000000000000000000001
1000000000000000000000000000000000000000000000000000000000000001
1000000000000000000000000000000000000000000000000000000000000001
1000000000000000000000000000000000000000000000000000000000000001
1000000001000000000000000000011111100000000000000000001000000001
1000000001111111111111111111112222111111111111111111111000000001
1111111111222222222222222222222222222222222222222222221111111111